00000000000000000000000000000000000000000000000000000000000000000000000000000000000000000000000000000000000000000000000000000000000000000000000000000000000000000000000000000000000000000000000000000000
00000000000000000000000000000000000000000000000000000000000000000000000000000000000000000000000000000000000000000000000000000000000000000000000000000000000000000000000000000000000000000000000000000000
00000000000000000000000000000000000000000000000000000000000000000000000000000000000000000000000000000000000000000000000000000000000000000000000000000000000000000000000000000000000000000000000000000000
11111111111110000000000000000000000000000000000000000000000000000000000000000000000000000000000000000000000000000000000000000000000000000000000000000000000000000000000000000000000000000000000000000000
11111111111111110000000000000000000000000000000000000000000000000000000000000000000000000000000000000000000000000000000000000000000000000000000000000000000000000000000000000000000000000000000000000000
11111111111111111000000000000000000000000000000000000000000000000000000000000000000000000000000000000000000000000000000000000000000000000000000000000000000000000000000000000000000000000000000000000000
11111111111111111110000000000000000000000000000000000000000000000000000000000000000000000000000000000000000000000000000000000000000000000000000000000000000000000000000000000000000000000000000000000000
11111111111111111111000000000000000000000000000000000000000000000000000000000000000000000000000000000000000000000000000000000000000000000000000000000000000000000000000000000000000000000000000000000000
11111111111111111111100000000000000000000000000000000000000000000000000000000000000000000000000000000000000000000000000000000000000000000000000000000000000000000000000000000000000000000000000000000000
11111111111111111111110000000000000000000000000000000000000000000000000000000000000000000000000000000000000000000000000000000000000000000000000000000000000000000000000000000000000000000000000000000000
11111111111111111111111000000000000000000000000000000000000000000000000000000000000000000000000000000000000000000000000000000000000000000000000000000000000000000000000000000000000000000000000000000000
00001111111111111111111000000000000000000000000000000000000000000000000000000000000000000000000000000000000000000000000000000000000000000000000000000000000000000000000000000000000000000000000000000000
00000001111111111111111100000000000000000000000000000000000000000000000000000000000000000000000000000000000000000000000000000000000000000000000000000000000000000000000000000000000000000000000000000000
00000000001111111111111110000000000000000000000000000000000000000000000000000000000000000000000000000000000000000000000000000000000000000000000000000000000000000000000000000000000000000000000000000000
00000000000111111111111111000000000000000000000000000000000000000000000000000000000000000000000000000000000000000000000000000000000000000000000000000000000000000000000000000000000000000000000000000000
00000000000011111111111111000000000000000000000000000000000000000000000000000000000000000000000000000000000000000000000000000000000000000000111111000000000000000000000000000000000000000000000000000000
00000000000001111111111111100000000000000000000000000000000000000000000000000000000000000000000000000000000000000000000000000000000000000111111111111110000000000000000000000000000000000000000000000000
00000000000000111111111111110000000000000000000000000000000000000000000000000000000000000000000000000000000000000000000000000000000000111111111111111111110000000000000000000000000000000000000000000000
00000000000000011111111111111000000000000000000000000000000000000000000000000000000000000000000000000000000000000000000000000000000001111111111111111111111110000000000000000000000000000000000000000000
00000000000000001111111111111000000000000000000000000000000000000000000000000000000000000000000000000000000000000000000000000000000111111111111111111111111111000000000000000000000000000000000000000000
00000000000000001111111111111100000000000000000000000000000000000000000000000000000000000000000000000000000000000000000000000000001111111111111111111111111111110000000000000000000000000000000000000000
00000000000000000111111111111110000000000000000000000000000000000000000000000000000000000000000000000000000000000000000000000000111111111111111111111111111111111000000000000000000000000000000000000000
00000000000000000011111111111110000000000000000000000000000000000000000000000000000000000000000000000000000000000000000000000001111111111111111111111111111111111100000000000000000000000000000000000000
00000000000000000001111111111110000000000000000000000000000000000000000000000000000000000000000000000000000000000000000000000011111111111111111111111111111111111111000000000000000000000000000000000000
00000000000000000001111111111111000000000000000000000000000000000000000000000000000000000000000000000000000000000000000000000111111111111111111111111111111111111111100000000000000000000000000000000000
00000000000000000000111111111111100000000000000000000000000000000000000000000000000000000000000000000000000000000000000000000111111111111111111111111111111111111111100000000000000000000000000000000000
00000000000000000000011111111111110000000000000000000000000000000000000000000000000000000000000000000000000000000000000000001111111111111111000000011111111111111111110000000000000000000000000000000000
00000000000000000000011111111111110000000000000000000000000000000000000000000000000000000000000000000000000000000000000000001111111111111110000000000011111111111111110000000000000000000000000000000000
00000000000000000000001111111111110000000000000000000000000000000000000000000000000000000000000000000000000000000000000000011111111111111100000000000000111111111111111000000000000000000000000000000000
00000000000000000000001111111111111000000000000000000000000000000000000000000000000000000000000000000000000000000000000000111111111111110000000000000000011111111111111100000000000000000000000000000000
00000000000000000000000111111111111100000000000000000000000000000000000000000000000000000000000000000000000000000000000001111111111111100000000000000000000111111111111100000000000000000000000000000000
00000000000000000000000011111111111110000000000000000000000000000000000000000000000000000000000000000000000000000000000001111111111111000000000000000000000011111111111110000000000000000000000000000000
00000000000000000000000001111111111110000000000000000000000000000000000000000000000000000000000000000000000000000000000011111111111110000000000000000000000011111111111110000000000000000000000000000000
00000000000000000000000001111111111110000000000000000000000000000000000000000000000000000000000000000000000000000000000111111111111110000000000000000000000001111111111111000000000000000000000000000000
00000000000000000000000001111111111111000000000000000000000000000000000000000000000000000000000000000000000000000000001111111111111100000000000000000000000000111111111111000000000000000000000000000000
00000000000000000000000000111111111111000000000000000000000000000000000000000000000000000000000000000000000000000000001111111111111000000000000000000000000000111111111111100000000000000000000000000000
00000000000000000000000000011111111111100000000000000000000000000000000000000000000000000000000000000000000000000000011111111111110000000000000000000000000000011111111111110000000000000000000000000000
00000000000000000000000000011111111111100000000000000000000000000000000000000000000000000000000000000000000000000000111111111111110000000000000000000000000000001111111111111000000000000000000000000000
00000000000000000000000000001111111111100000000000000000000000000000000000000000000000000000000000000000000000000000111111111111100000000000000000000000000000001111111111111000000000000000000000000000
00000000000000000000000000001111111111110000000000000000000000000000000000000000000000000000000000000000000000000001111111111111000000000000000000000000000000000111111111111100000000000000000000000000
00000000000000000000000000000111111111110000000000000000000000000000000000000000000000000000000000000000000000000001111111111110000000000000000000000000000000000011111111111110000000000000000000000000
00000000000000000000000000000111111111110000000000000000000000000000000000000000000000000000000000000000000000000001111111111110000000000000000000000000000000000011111111111110000000000000000000000000
00000000000000000000000000000111111111111000000000000000000000000000000000000000000000000000000000000000000000000011111111111100000000000000000000000000000000000001111111111111000000000000000000000000
00000000000000000000000000000011111111111000000000000000000000000000000000000000000000000000000000000000000000000111111111111100000000000000000000000000000000000000111111111111000000000000000000000000
00000000000000000000000000000011111111111100000000000000000000000000000000000000000000000000000000000000000000000111111111111000000000000000000000000000000000000000111111111111000000000000000000000000
00000000000000000000000000000011111111111100000000000000000000000000000000000000000000000000000000000000000000001111111111111000000000000000000000000000000000000000111111111111100000000000000000000000
00000000000000000000000000000001111111111110000000000000000000000000000000000000000000000000000000000000000000001111111111110000000000000000000000000000000000000000011111111111100000000000000000000000
00000000000000000000000000000001111111111110000000000000000000000000000000000000000000000000000000000000000000011111111111110000000000000000000000000000000000000000001111111111110000000000000000000000
00000000000000000000000000000000111111111111000000000000000000000000000000000000000000000000000000000000000000111111111111100000000000000000000000000000000000000000001111111111110000000000000000000000
00000000000000000000000000000000111111111111000000000000000000000000000000000000000000000000000000000000000001111111111111100000000000000000000000000000000000000000000111111111111000000000000000000000
00000000000000000000000000000000111111111111100000000000000000000000000000000000000000000000000000000000000001111111111111000000000000000000000000000000000000000000000111111111111000000000000000000000
00000000000000000000000000000000011111111111100000000000000000000000000000000000000000000000000000000000000011111111111110000000000000000000000000000000000000000000000011111111111100000000000000000000
00000000000000000000000000000000011111111111100000000000000000000000000000000000000000000000000000000000000011111111111110000000000000000000000000000000000000000000000011111111111100000000000000000000
00000000000000000000000000000000001111111111110000000000000000000000000000000000000000000000000000000000000111111111111100000000000000000000000000000000000000000000000001111111111110000000000000000000
00000000000000000000000000000000000111111111110000000000000000000000000000000000000000000000000000000000000111111111111000000000000000000000000000000000000000000000000001111111111110000000000000000000
00000000000000000000000000000000000111111111110000000000000000000000000000000000000000000000000000000000001111111111110000000000000000000000000000000000000000000000000000111111111111000000000000000000
00000000000000000000000000000000000111111111110000000000000000000000000000000000000000000000000000000000001111111111110000000000000000000000000000000000000000000000000000111111111111100000000000000000
00000000000000000000000000000000000011111111111000000000000000000000000000000000000000000000000000000000011111111111100000000000000000000000000000000000000000000000000000111111111111100000000000000000
00000000000000000000000000000000000011111111111000000000000000000000000000000000000000000000000000000000011111111111100000000000000000000000000000000000000000000000000000011111111111110000000000000000
00000000000000000000000000000000000011111111111000000000000000000000000000000000000000000000000000000000111111111111100000000000000000000000000000000000000000000000000000001111111111111000000000000000
00000000000000000000000000000000000001111111111100000000000000000000000000000000000000000000000000000001111111111111000000000000000000000000000000000000000000000000000000001111111111111000000000000000
00000000000000000000000000000000000001111111111110000000000000000000000000000000000000000000000000000011111111111111000000000000000000000000000000000000000000000000000000000111111111111100000000000000
00000000000000000000000000000000000001111111111110000000000000000000000000000000000000000000000000000111111111111110000000000000000000000000000000000000000000000000000000000111111111111100000000000000
00000000000000000000000000000000000000111111111111000000000000000000000000000000000000000000000000001111111111111100000000000000000000000000000000000000000000000000000000000011111111111110000000000000
00000000000000000000000000000000000000111111111111100000000000000000000000000000000000000000000000001111111111111100000000000000000000000000000000000000000000000000000000000001111111111110000000000000
00000000000000000000000000000000000000111111111111110000000000000000000000000000000000000000000000011111111111111000000000000000000000000000000000000000000000000000000000000001111111111111000000000000
00000000000000000000000000000000000000011111111111110000000000000000000000000000000000000000000001111111111111111000000000000000000000000000000000000000000000000000000000000000111111111111100000000000
00000000000000000000000000000000000000011111111111111000000000000000000000000000000000000000000011111111111111110000000000000000000000000000000000000000000000000000000000000000111111111111111000000000
00000000000000000000000000000000000000001111111111111100000000000000000000000000000000000000000111111111111111100000000000000000000000000000000000000000000000000000000000000000011111111111111100000000
00000000000000000000000000000000000000000111111111111100000000000000000000000000000000000000001111111111111111000000000000000000000000000000000000000000000000000000000000000000001111111111111111000000
00000000000000000000000000000000000000000011111111111110000000000000000000000000000000000000011111111111111110000000000000000000000000000000000000000000000000000000000000000000001111111111111111111111
00000000000000000000000000000000000000000011111111111111000000000000000000000000000000000000111111111111111100000000000000000000000000000000000000000000000000000000000000000000000111111111111111111111
00000000000000000000000000000000000000000001111111111111110000000000000000000000000000000001111111111111111000000000000000000000000000000000000000000000000000000000000000000000000111111111111111111111
00000000000000000000000000000000000000000001111111111111111000000000000000000000000000000011111111111111110000000000000000000000000000000000000000000000000000000000000000000000000011111111111111111111
00000000000000000000000000000000000000000000111111111111111100000000000000000000000000000111111111111111100000000000000000000000000000000000000000000000000000000000000000000000000001111111111111111111
00000000000000000000000000000000000000000000011111111111111110000000000000000000000000000111111111111111000000000000000000000000000000000000000000000000000000000000000000000000000000111111111111111111
00000000000000000000000000000000000000000000001111111111111111000000000000000000000000001111111111111100000000000000000000000000000000000000000000000000000000000000000000000000000000001111111111111111
00000000000000000000000000000000000000000000001111111111111111100000000000000000000000011111111111111100000000000000000000000000000000000000000000000000000000000000000000000000000000000011111111111111
00000000000000000000000000000000000000000000000111111111111111111000000000000000000001111111111111111000000000000000000000000000000000000000000000000000000000000000000000000000000000000000111111111111
00000000000000000000000000000000000000000000000011111111111111111100000000000000000011111111111111110000000000000000000000000000000000000000000000000000000000000000000000000000000000000000000111111111
00000000000000000000000000000000000000000000000000111111111111111110000000000000000111111111111111100000000000000000000000000000000000000000000000000000000000000000000000000000000000000000000000000000
00000000000000000000000000000000000000000000000000011111111111111111100000000000011111111111111111000000000000000000000000000000000000000000000000000000000000000000000000000000000000000000000000000000
00000000000000000000000000000000000000000000000000001111111111111111111000000000111111111111111110000000000000000000000000000000000000000000000000000000000000000000000000000000000000000000000000000000
00000000000000000000000000000000000000000000000000000111111111111111111111111111111111111111111100000000000000000000000000000000000000000000000000000000000000000000000000000000000000000000000000000000
00000000000000000000000000000000000000000000000000000011111111111111111111111111111111111111111100000000000000000000000000000000000000000000000000000000000000000000000000000000000000000000000000000000
00000000000000000000000000000000000000000000000000000000111111111111111111111111111111111111111000000000000000000000000000000000000000000000000000000000000000000000000000000000000000000000000000000000
00000000000000000000000000000000000000000000000000000000011111111111111111111111111111111111100000000000000000000000000000000000000000000000000000000000000000000000000000000000000000000000000000000000
00000000000000000000000000000000000000000000000000000000001111111111111111111111111111111111000000000000000000000000000000000000000000000000000000000000000000000000000000000000000000000000000000000000
00000000000000000000000000000000000000000000000000000000000011111111111111111111111111111110000000000000000000000000000000000000000000000000000000000000000000000000000000000000000000000000000000000000
00000000000000000000000000000000000000000000000000000000000001111111111111111111111111111100000000000000000000000000000000000000000000000000000000000000000000000000000000000000000000000000000000000000
00000000000000000000000000000000000000000000000000000000000000011111111111111111111111110000000000000000000000000000000000000000000000000000000000000000000000000000000000000000000000000000000000000000
00000000000000000000000000000000000000000000000000000000000000001111111111111111111111000000000000000000000000000000000000000000000000000000000000000000000000000000000000000000000000000000000000000000
00000000000000000000000000000000000000000000000000000000000000000011111111111111111110000000000000000000000000000000000000000000000000000000000000000000000000000000000000000000000000000000000000000000
00000000000000000000000000000000000000000000000000000000000000000000000000000000000000000000000000000000000000000000000000000000000000000000000000000000000000000000000000000000000000000000000000000000
00000000000000000000000000000000000000000000000000000000000000000000000000000000000000000000000000000000000000000000000000000000000000000000000000000000000000000000000000000000000000000000000000000000
00000000000000000000000000000000000000000000000000000000000000000000000000000000000000000000000000000000000000000000000000000000000000000000000000000000000000000000000000000000000000000000000000000000
00000000000000000000000000000000000000000000000000000000000000000000000000000000000000000000000000000000000000000000000000000000000000000000000000000000000000000000000000000000000000000000000000000000
00000000000000000000000000000000000000000000000000000000000000000000000000000000000000000000000000000000000000000000000000000000000000000000000000000000000000000000000000000000000000000000000000000000
00000000000000000000000000000000000000000000000000000000000000000000000000000000000000000000000000000000000000000000000000000000000000000000000000000000000000000000000000000000000000000000000000000000
00000000000000000000000000000000000000000000000000000000000000000000000000000000000000000000000000000000000000000000000000000000000000000000000000000000000000000000000000000000000000000000000000000000
